BEBBBBBBBB
BEBBJDDDMB
BEBBEBBBEB
BEBBEBBBEB
BGDDCDDDHM
BEBBEBBBBE
BEBBEDDMBE
BEBBBBBBBB
