BEBBBBBBBB
BEBBJDDDMB
BEBBEBBBEB
BEAAEBBBEB
BGDDCDDDHM
BEAAEBBBBE
BEAAEDDMBE
BEAAEEEEBE
BEAAEAAEBE
BKDDLAAKDL