1111222233
1222233331
1233332211
1222231111
1111122223
3333222222
3332221111
1111222333
1222233111
1111222233